21 35 test 10 0 2 3
10 10 10 10 10 10 10 10 10 10 10 10 10 10 10 10 10 10 10 10 10
10  0  0  0  0  0  0  0  0  0  0  0  0  0  0  0  0  0  0  0 10
10  0  0  0  0  0  0  0  0  0  0  0  0  0  0  0  0  0  0  0 10
10  0  0 10 10  0  0 10 10  0  0  0 10 10 10 10 10  0  0  0 10
10  0  0 10 10  0  0 10 10  0  0  0  0  0  0  0 10 10  0  0 10
10  0  0 10 10  0  0 10 10  0  0  0  0  0  0  0 10 10  0  0 10
10  0  0 10 10 10 10 10 10  0  0  0  0 10 10 10 10  0  0  0 10
10  0  0  0 10 10 10 10 10  0  0  0 10 10  0  0  0  0  0  0 10
10  0  0  0  0  0  0 10 10  0  0  0 10 10  0  0  0  0  0  0 10
10  0  0 10  0 10  0 10  0 10  0 10  0 10  0 10  0 10  0 10 10
10  0  0  0  0  0  0  0  0  0  0  0  0  0  0  0  0  0  0  0 10
10  2  0  0  3  0  0  0  0  0  0  0  0  0  0  0  0  0  0  0 10
10  0  0  0  0  0  0  0  0  0  0  0  0  0  0  0  0  0  0  0 10
10  0  0  0  0  0  0  0  0  0  0  0  0  0  0  0  0  0  0  0 10
10  0  0 10 10  0  0 10 10  0  0  0 10 10 10 10 10  0  0  0 10
10  0  0 10 10  0  0 10 10  0  0  0  0  0  0  0 10 10  0  0 10
10  0  0 10 10  3  0 10 10  0  0  0  0  0  0  0 10 10  0  0 10
10  0  0 10 10 10 10 10 10  0  0  0  0 10 10 10 10  0  0  0 10
10  0  0  0 10 10 10 10 10  0  0  0 10 10  0  0  0  0  0  0 10
10  0  0  0  0  0  0 10 10  0  0  0 10 10  0  0  0  0  0  0 10
10  0  0  0  0  0  0 10 10  0  0  0 10 10 10 10 10 10  0  0 10
10  0  0  0  0  0  0  0  0  0  0  0  0  0  0  0  0  0  0  0 10
10  0  0  0  0  0  0  0  0  0  0  0  0  0  0  0  0  0  0  0 10
10  0  0  0  0  0  0  0  0  0  0  0  0  0  0  0  0  0  0  0 10
10  0  0  0  0  0  0  0  0  0  0  0  0  0  0  0  0  0  0  0 10
10  0  0 10 10  0  0 10 10  0  0  0 10 10 10 10 10  0  0  0 10
10  0  0 10 10  0  0 10 10  0  0  0  0  0  0  0 10 10  0  0 10
10  0  0 10 10  0  0 10 10  0  0  0  0  0  0  0 10 10  0  0 10
10  0  0 10 10 10 10 10 10  0  0  0  0 10 10 10 10  0  0  0 10
10  0  0  0 10 10 10 10 10  0  0  0 10 10  0  0  0  0  0  0 10
10  0  0  0  0  0  0 10 10  0  0  0 10 10  0  0  0  0  0  0 10
10  0  0  0  0  0  0 10 10  0  0  0 10 10 10 10 10 10  0  0 10
10  0  0  0  0  0  0  0  0  0  0  0  0  0  0  0  0  0  0  0 10
10  0  0  0  0  0  0  0  0  0  0  0  0  0  0  0  0  0  0  0 10
10 10 10 10 10 10 10 10 10 10 10 10 10 10 10 10 10 10 10 10 10
